{
"map":[
"WWWWWWWWWW",
"W--------W",
"W--------W",
"W--------W",
"W--------W",
"W--------W",
"W--------W",
"W--------W",
"W--------W",
"WWWWWWWWWW"
],

"start":
{"x":1,"y":1},

"map2":[
"WWWW",
"W--W",
"W--------W",
"w---W",
"WWWWW"
]

}
